date
1979-12-29
1980-02-01
1980-02-12
1980-02-13
1980-02-14
1980-02-15
1980-02-27
1983-02-15
1983-02-16
1983-02-17
1983-02-18
1983-02-22
1983-02-23
1983-02-25
1983-02-26
1983-02-27
1983-03-02
1983-03-03
1983-03-04
1983-03-05
1987-02-07
1987-02-08
1990-12-22
1990-12-23
1994-01-08
1994-12-13
1995-02-25
1995-02-26
1997-01-05
1997-01-06
1997-01-07
1997-01-21
1998-01-01
1998-01-02
1998-01-03
1998-01-14
1998-01-15
1998-01-16
1998-01-17
1998-01-18
1998-01-22
1998-01-23
1998-01-25
1998-02-01
2000-02-02
2000-02-04
2000-02-05
2000-02-06
2000-02-08
2000-03-02
2000-03-03
2001-01-05
2001-02-22
2002-10-18
2002-10-19
2002-11-02
2002-11-03
2002-11-12
2002-11-13
2003-01-07
2003-01-08
2003-01-13
2003-01-14
2003-01-18
2003-01-19
2003-01-20
2003-01-21
2003-01-22
2003-01-23
2003-01-24
2003-01-25
2003-02-03
2003-02-11
2003-06-06
2004-03-03
2004-03-22
2004-03-25
2004-03-26
2005-01-11
2005-01-12
2005-01-14
2005-03-10
2005-03-11
2005-03-12
2006-01-22
2006-01-23
2006-01-26
2009-01-31
2009-02-01
2009-02-05
2009-02-06
2009-02-07
2009-02-08
2009-02-09
2011-02-01
2011-02-02
2011-04-04
2011-04-05
2011-04-15
2011-04-16
2011-04-17
2011-04-18
2012-03-13
2013-01-04
2013-01-08
2013-01-09
2013-01-10
2013-01-11
2013-02-07
2013-02-09
2013-02-21
2013-03-12
2013-03-20
2013-04-09
2013-04-10
2013-05-01
2013-05-02
2013-10-17
2014-01-28
2014-02-03
2014-02-08
2014-02-09
2015-04-30
2015-05-01
2016-01-20
2017-01-30
2017-03-28
2017-03-29
2017-03-30
2017-04-04
2017-04-06
2017-04-07
2018-11-28
2018-12-01
2019-01-25
2019-01-30
2019-11-20
2019-11-21
2019-12-20
2020-01-04
2022-02-28
2022-05-09
2022-05-10
2023-12-08
2023-12-11
2023-12-13
